0 0 0 0 0 0 0 0 0 0 0 0 0 0 0 0 0 0 0 0 0 0 0 0 0 0 0 0 0 0 0 0 0 0 0 0 0 0 0 0 0 0 0 0 0 0 0 0 0 0 0 0 0 0 0 0 0 0 0 0 0 0 0 0 0 0 0 0 0 0 0 0 0 0 0 0 0 0 0 0 0 0 0 0 0 0 0 0 0 0 0 0 0 0 0 0 0 0 0 0 
0 0 0 0 0 0 0 0 0 0 0 0 0 0 0 0 0 0 0 0 0 0 0 0 0 0 0 0 0 0 0 0 0 0 0 0 0 0 0 0 0 0 0 0 0 0 0 0 0 0 0 0 0 0 0 0 0 0 0 0 0 0 0 0 0 0 0 0 0 0 0 0 0 0 0 0 0 0 0 0 0 0 0 0 0 0 0 0 0 0 0 0 0 0 0 0 0 0 0 0 
0 0 0 0 0 0 0 0 0 0 0 0 0 0 0 0 0 0 0 0 0 0 0 0 0 0 0 0 0 0 0 0 0 0 0 0 0 0 0 0 0 0 0 0 0 0 0 0 0 0 0 0 0 0 0 0 0 0 0 0 0 0 0 0 0 0 0 0 0 0 0 0 0 0 0 0 0 0 0 0 0 0 0 0 0 0 0 0 0 0 0 0 0 0 0 0 0 0 0 0 
0 0 0 0 0 0 0 0 0 0 0 0 0 0 0 0 0 0 0 0 0 0 0 0 0 0 0 0 0 0 0 0 0 0 0 0 0 0 0 0 0 0 0 0 0 0 0 0 0 0 0 0 0 0 0 0 0 0 0 0 0 0 0 0 0 0 0 0 0 0 0 0 0 0 0 0 0 0 0 0 0 0 0 0 0 0 0 0 0 0 0 0 0 0 0 0 0 0 0 0 
0 0 0 0 0 0 0 0 0 0 0 0 0 0 0 0 0 0 0 0 0 0 0 0 0 0 0 0 0 0 0 0 0 0 0 0 0 0 0 0 0 0 0 0 0 0 0 0 0 0 0 0 0 0 0 0 0 0 0 0 0 0 0 0 0 0 0 0 0 0 0 0 0 0 0 0 0 0 0 0 0 0 0 0 0 0 0 0 0 0 0 0 0 0 0 0 0 0 0 0 
0 0 0 0 0 0 0 0 0 0 0 0 0 0 0 0 0 0 0 0 0 0 0 0 0 0 0 0 0 0 0 0 0 0 0 0 0 0 0 0 0 0 0 0 0 0 0 0 0 0 0 0 0 0 0 0 0 0 0 0 0 0 0 0 0 0 0 0 0 0 0 0 0 0 0 0 0 0 0 0 0 0 0 0 0 0 0 0 0 0 0 0 0 0 0 0 0 0 0 0 
0 0 0 0 0 0 0 0 0 0 0 0 0 0 0 0 0 0 0 0 0 0 0 0 0 0 0 0 0 0 0 0 0 0 0 0 0 0 0 0 0 0 0 0 0 0 0 0 0 0 0 0 0 0 0 0 0 0 0 0 0 0 0 0 0 0 0 0 0 0 0 0 0 0 0 0 0 0 0 0 0 0 0 0 0 0 0 0 0 0 0 0 0 0 0 0 0 0 0 0 
0 0 0 0 0 0 0 0 0 0 0 0 0 0 0 0 0 0 0 0 0 0 0 0 0 0 0 25 17 17 17 17 17 24 0 0 0 0 0 0 0 0 0 0 0 0 0 0 0 0 0 0 0 0 0 0 0 0 0 0 0 0 0 0 0 0 0 0 0 0 0 0 0 0 0 0 0 0 0 0 0 0 0 0 0 0 0 0 0 0 0 0 0 0 0 0 0 0 0 0 
0 0 0 0 0 0 0 0 0 0 0 0 0 0 0 0 0 0 0 0 0 0 0 0 0 0 0 21 14 14 14 14 14 20 17 17 17 17 17 17 24 0 0 0 0 0 0 0 0 0 0 0 0 0 0 0 0 0 0 0 0 0 0 0 0 0 0 0 0 0 0 0 0 0 0 0 0 0 0 0 0 0 0 0 0 0 0 0 0 0 0 0 0 0 0 0 0 0 0 0 
0 0 0 0 0 0 0 0 0 0 0 0 0 0 0 0 0 0 0 0 0 0 0 0 0 0 18 14 30 30 14 30 14 14 14 14 30 30 14 14 20 17 17 24 0 0 0 0 0 0 0 0 0 0 0 0 0 0 0 0 0 0 0 0 0 0 0 0 0 0 0 0 0 0 0 0 0 0 0 0 0 0 0 0 0 0 0 0 0 0 0 0 0 0 0 0 0 0 0 0 
0 0 0 0 0 0 0 0 0 0 0 0 0 0 0 0 0 0 0 0 0 0 0 0 0 0 18 14 30 14 14 10 3 3 3 3 3 3 3 3 3 13 14 20 17 17 24 0 25 17 17 17 17 17 17 17 17 17 17 17 17 17 17 17 17 17 24 0 0 0 0 0 0 0 0 0 0 0 0 0 0 0 0 0 0 0 0 0 0 0 0 0 0 0 0 0 0 0 0 0 
0 0 0 0 0 0 0 0 0 0 0 0 0 0 0 0 0 0 0 0 0 0 0 0 0 0 18 14 30 30 14 5 31 31 31 31 31 31 31 31 31 4 30 14 14 14 20 17 21 14 14 14 14 14 14 14 14 14 14 14 14 14 14 14 14 14 19 0 0 0 0 0 0 0 0 0 0 0 0 0 0 0 0 0 0 0 0 0 0 0 0 0 0 0 0 0 0 0 0 0 
0 0 0 0 0 0 0 0 0 0 0 0 0 0 0 0 0 0 0 0 0 0 0 0 0 0 18 14 14 14 30 5 31 32 32 32 32 32 32 32 31 8 30 30 14 30 30 30 30 14 14 30 10 3 3 29 29 29 29 29 29 29 14 14 14 14 20 24 0 0 0 0 0 0 0 0 0 0 0 0 0 0 0 0 0 0 0 0 0 0 0 0 0 0 0 0 0 0 0 0 
0 0 0 0 0 0 0 0 0 0 0 0 0 0 0 0 0 0 0 0 0 0 0 0 0 0 0 23 14 14 30 5 31 32 32 32 32 32 32 32 31 31 4 14 14 14 14 14 30 30 30 30 5 31 31 31 31 31 29 29 29 29 14 14 14 14 14 20 24 0 0 0 0 0 0 0 0 0 0 0 0 0 0 0 0 0 0 0 0 0 0 0 0 0 0 0 0 0 0 0 
0 0 0 0 0 0 0 0 0 0 0 0 0 0 0 0 0 0 0 0 0 0 0 0 0 0 0 0 23 14 14 5 31 32 32 32 32 32 32 32 32 31 4 30 14 30 30 14 14 30 30 14 5 31 32 32 32 32 29 29 29 29 14 30 30 30 14 14 19 0 0 0 0 0 0 0 0 0 0 0 0 0 0 0 0 0 0 0 0 0 0 0 0 0 0 0 0 0 0 0 
0 0 0 0 0 0 0 0 0 0 0 0 0 0 0 0 0 0 0 0 0 0 0 0 0 0 0 0 18 14 30 5 31 31 31 31 31 31 31 31 32 31 4 30 14 14 14 10 3 3 3 3 7 31 32 32 32 31 31 29 29 29 14 14 30 30 14 22 26 0 0 0 0 0 0 0 0 0 0 0 0 0 0 0 0 0 0 0 0 0 0 0 0 0 0 0 0 0 0 0 
0 0 0 0 0 0 0 0 0 0 0 0 0 0 0 0 0 0 0 0 0 0 0 0 0 0 0 0 18 14 14 12 2 2 2 2 2 2 9 31 32 31 4 30 14 14 14 5 32 32 32 32 32 32 32 32 32 32 31 4 14 14 14 30 14 14 22 26 0 0 0 0 0 0 0 0 0 0 0 0 0 0 0 0 0 0 0 0 0 0 0 0 0 0 0 0 0 0 0 0 
0 0 0 0 0 0 0 0 0 0 0 0 0 0 0 0 0 0 0 0 0 0 0 0 0 0 0 0 18 14 14 30 30 30 30 14 30 30 12 9 32 6 11 14 14 14 30 5 32 6 2 2 9 31 32 32 32 32 31 4 14 30 30 14 14 22 26 0 0 0 0 0 0 0 0 0 0 0 0 0 0 0 0 0 0 0 0 0 0 0 0 0 0 0 0 0 0 0 0 0 
0 0 0 0 0 0 0 0 0 0 0 0 0 0 0 0 0 0 0 0 0 0 0 0 0 0 0 25 21 14 14 30 30 30 14 14 14 14 30 5 32 4 30 30 14 30 14 5 32 4 30 30 5 31 31 31 31 31 31 4 30 30 30 14 22 26 0 0 0 0 0 0 0 0 0 0 0 0 0 0 0 0 0 0 0 0 0 0 0 0 0 0 0 0 0 0 0 0 0 0 
0 0 0 0 0 0 0 0 0 0 0 0 0 0 0 0 0 0 0 0 0 0 25 17 17 17 17 21 14 30 30 14 14 30 14 30 30 14 14 5 32 4 14 30 30 14 14 5 32 4 30 30 12 2 2 2 2 2 2 11 30 30 14 14 19 0 0 0 0 0 0 0 0 0 0 0 0 0 0 0 0 0 0 0 0 0 0 0 0 0 0 0 0 0 0 0 0 0 0 0 
0 0 0 0 0 0 0 0 0 0 0 0 0 0 0 0 0 0 25 17 17 17 21 14 14 14 14 14 30 30 30 14 30 30 30 30 30 30 30 5 32 4 14 14 14 30 30 5 32 4 30 30 30 30 14 14 14 14 30 14 30 14 14 22 26 0 0 0 0 0 0 0 0 0 0 0 0 0 0 0 0 0 0 0 0 0 0 0 0 0 0 0 0 0 0 0 0 0 0 0 
0 0 0 0 0 0 0 0 0 0 0 0 0 0 0 25 17 17 21 14 14 14 14 30 30 30 30 30 10 3 3 3 3 3 3 3 3 3 3 7 32 8 3 3 3 3 3 7 32 4 14 14 14 30 30 30 30 30 30 14 14 14 22 26 0 0 0 0 0 0 0 0 0 0 0 0 0 0 0 0 0 0 0 0 0 0 0 0 0 0 0 0 0 0 0 0 0 0 0 0 
0 0 0 0 0 0 0 0 0 0 0 0 0 0 25 21 14 14 10 3 3 3 3 3 3 3 3 13 5 32 32 32 32 32 32 32 32 32 32 32 32 32 32 32 32 32 32 32 32 4 14 14 14 14 30 30 14 30 30 14 14 22 26 0 0 0 0 0 0 0 0 0 0 0 0 0 0 0 0 0 0 0 0 0 0 0 0 0 0 0 0 0 0 0 0 0 0 0 0 0 
0 0 0 0 0 0 0 0 0 0 0 0 0 0 18 14 14 30 5 32 32 32 32 32 32 32 32 4 5 32 6 2 2 2 2 2 2 2 2 2 2 2 2 2 2 2 2 9 32 4 30 30 14 14 14 30 14 30 30 14 22 26 0 0 0 0 0 0 0 0 0 0 0 0 0 0 0 0 0 0 0 0 0 0 0 0 0 0 0 0 0 0 0 0 0 0 0 0 0 0 
0 0 0 0 0 0 0 0 0 0 0 0 25 17 21 14 14 30 5 32 31 31 31 31 31 31 32 4 5 32 4 30 30 30 30 14 30 30 30 30 30 30 30 30 14 14 14 5 32 4 30 30 30 14 14 14 30 14 30 14 19 0 0 0 0 0 0 0 0 0 0 0 0 0 0 0 0 0 0 0 0 0 0 0 0 0 0 0 0 0 0 0 0 0 0 0 0 0 0 0 
0 0 0 0 0 0 0 0 0 0 0 0 18 14 14 14 30 30 5 32 31 32 32 32 32 31 32 8 7 32 4 30 14 30 14 14 14 30 14 30 30 14 14 30 14 30 30 5 32 4 14 30 30 14 14 14 30 14 30 14 19 0 0 0 0 0 0 0 0 0 0 0 0 0 0 0 0 0 0 0 0 0 0 0 0 0 0 0 0 0 0 0 0 0 0 0 0 0 0 0 
0 0 0 0 0 0 0 0 0 0 0 0 18 14 14 10 3 3 7 32 31 32 32 32 32 31 32 32 32 32 8 3 13 30 30 30 14 30 14 14 30 30 30 30 14 30 30 5 32 4 14 30 30 30 30 30 30 30 14 14 19 0 0 0 0 0 0 0 0 0 0 0 0 0 0 0 0 0 0 0 0 0 0 0 0 0 0 0 0 0 0 0 0 0 0 0 0 0 0 0 
0 0 0 0 0 0 0 0 0 0 0 0 18 14 30 5 32 32 32 31 31 32 32 32 32 31 31 32 32 32 32 32 4 14 14 14 30 30 14 14 14 30 30 30 14 30 30 5 32 4 30 14 30 30 14 14 30 14 30 14 20 17 24 0 0 0 0 0 0 0 0 0 0 0 0 0 0 0 0 0 0 0 0 0 0 0 0 0 0 0 0 0 0 0 0 0 0 0 0 0 
0 0 0 0 0 0 0 0 0 0 0 0 18 14 30 5 32 31 31 31 32 32 32 32 32 32 31 31 31 32 31 32 4 30 14 30 30 14 14 22 16 23 14 14 14 30 14 5 32 4 30 30 30 14 30 30 14 14 14 30 14 14 20 24 0 0 0 0 0 0 0 0 0 0 0 0 0 0 0 0 0 0 0 0 0 0 0 0 0 0 0 0 0 0 0 0 0 0 0 0 
0 0 0 0 0 0 0 0 0 0 0 0 18 14 30 5 32 31 32 32 32 32 32 32 32 32 32 32 32 32 31 32 4 14 14 30 14 14 14 19 0 27 16 23 14 14 30 5 32 8 3 3 13 14 30 30 14 30 30 30 14 14 14 20 24 0 0 0 0 0 0 0 0 0 0 0 0 0 0 0 0 0 0 0 0 0 0 0 0 0 0 0 0 0 0 0 0 0 0 0 
0 0 0 0 0 0 0 0 0 0 0 0 18 14 30 5 32 31 32 32 32 32 32 32 32 32 32 32 32 32 31 32 4 14 30 30 14 14 22 26 0 0 0 27 23 14 14 5 32 32 32 32 4 14 14 30 10 3 3 3 3 13 14 14 20 24 0 0 0 0 0 0 0 0 0 0 0 0 0 0 0 0 0 0 0 0 0 0 0 0 0 0 0 0 0 0 0 0 0 0 
0 0 0 0 0 0 0 0 0 0 0 0 18 14 30 5 32 31 32 32 32 32 32 32 32 32 32 32 32 32 31 32 4 30 30 14 14 14 19 0 0 0 0 0 27 16 23 12 2 2 9 32 4 14 30 30 5 31 31 31 31 4 30 30 14 20 24 0 0 0 0 0 0 0 0 0 0 0 0 0 0 0 0 0 0 0 0 0 0 0 0 0 0 0 0 0 0 0 0 0 
0 0 0 0 0 0 0 0 0 0 0 0 18 14 30 5 32 31 32 32 32 32 32 32 32 32 32 32 32 32 31 32 4 30 14 14 14 22 26 0 0 0 0 0 0 0 27 23 14 30 5 32 8 3 3 3 7 31 32 32 31 4 30 30 14 14 20 24 0 0 0 0 0 0 0 0 0 0 0 0 0 0 0 0 0 0 0 0 0 0 0 0 0 0 0 0 0 0 0 0 
0 0 0 0 0 0 0 0 0 0 0 0 18 14 30 5 32 31 31 31 31 31 31 31 31 31 31 31 31 31 31 32 4 30 30 14 14 20 17 24 0 0 0 0 0 0 0 18 14 30 5 32 32 32 32 32 32 32 32 32 31 4 30 30 30 14 14 20 24 0 0 0 0 0 0 0 0 0 0 0 0 0 0 0 0 0 0 0 0 0 0 0 0 0 0 0 0 0 0 0 
0 0 0 0 0 0 0 0 0 0 0 0 18 14 14 5 32 32 32 32 32 32 32 32 32 32 32 32 32 32 32 32 4 14 14 30 14 14 14 20 17 17 24 0 0 0 0 18 14 30 5 32 6 2 2 2 9 31 32 32 31 4 14 30 14 30 14 14 19 0 0 0 0 0 0 0 0 0 0 0 0 0 0 0 0 0 0 0 0 0 0 0 0 0 0 0 0 0 0 0 
0 0 0 0 0 0 0 0 0 0 0 0 27 23 14 12 2 2 2 2 2 2 2 2 2 2 2 2 2 2 2 2 11 30 14 30 14 30 14 14 14 14 20 17 17 17 17 21 14 14 5 32 4 30 14 14 5 31 31 31 31 4 30 30 14 14 14 14 20 24 0 0 0 0 0 0 0 0 0 0 0 0 0 0 0 0 0 0 0 0 0 0 0 0 0 0 0 0 0 0 
0 0 0 0 0 0 0 0 0 0 0 0 0 18 14 14 30 14 30 30 30 30 30 30 14 14 14 30 30 30 30 14 30 14 14 30 30 30 14 30 14 14 14 14 10 3 3 3 3 3 7 32 4 14 14 14 12 2 2 2 2 11 14 30 30 30 30 14 14 20 17 17 24 0 0 0 0 0 0 0 0 0 0 0 0 0 0 0 0 0 0 0 0 0 0 0 0 0 0 0 
0 0 0 0 0 0 0 0 0 0 0 0 0 27 23 14 14 30 30 30 30 14 30 14 30 30 14 30 14 14 30 14 14 14 30 14 14 30 14 30 14 30 14 30 5 32 32 32 32 32 32 32 4 30 30 30 14 14 14 30 30 30 30 14 30 30 30 30 14 14 14 14 20 24 0 0 0 0 0 0 0 0 0 0 0 0 0 0 0 0 0 0 0 0 0 0 0 0 0 0 
0 0 0 0 0 0 0 0 0 0 0 0 0 0 27 16 23 14 14 14 14 14 30 14 14 30 14 30 10 3 3 3 13 30 14 30 30 30 30 14 14 14 14 30 5 32 6 2 2 2 2 2 11 30 14 30 14 30 30 30 14 30 30 14 14 30 14 14 30 30 14 30 14 19 0 0 0 0 0 0 0 0 0 0 0 0 0 0 0 0 0 0 0 0 0 0 0 0 0 0 
0 0 0 0 0 0 0 0 0 0 0 0 0 0 0 0 27 16 16 16 16 14 30 30 14 30 30 30 5 32 32 32 8 3 3 3 14 30 14 30 30 14 14 14 5 32 4 14 14 14 30 14 14 14 30 14 14 30 14 14 14 30 30 14 14 30 30 14 30 30 14 30 30 19 0 0 0 0 0 0 0 0 0 0 0 0 0 0 0 0 0 0 0 0 0 0 0 0 0 0 
0 0 0 0 0 0 0 0 0 0 0 0 0 0 0 0 0 0 0 0 27 23 30 30 14 30 14 14 5 32 32 32 32 32 32 32 4 30 14 14 30 30 30 30 5 32 4 14 30 30 30 30 14 14 14 14 30 30 30 14 14 14 14 30 14 30 30 14 14 14 30 14 14 19 0 0 0 0 0 0 0 0 0 0 0 0 0 0 0 0 0 0 0 0 0 0 0 0 0 0 
0 0 0 0 0 0 0 0 0 0 0 0 0 0 0 0 0 0 0 0 0 18 14 30 14 30 30 30 5 32 32 32 6 2 9 32 4 30 14 14 14 30 14 30 5 32 4 14 30 14 14 14 14 30 30 30 10 3 3 3 3 3 3 3 3 3 3 3 3 13 30 30 14 20 24 0 0 0 0 0 0 0 0 0 0 0 0 0 0 0 0 0 0 0 0 0 0 0 0 0 
0 0 0 0 0 0 0 0 0 0 0 0 0 0 0 0 0 0 0 0 25 21 14 30 14 30 14 14 5 32 32 32 4 10 7 32 4 30 14 30 14 30 30 30 5 32 4 14 30 14 14 14 14 30 30 14 5 32 32 32 32 32 32 32 32 32 32 32 32 4 14 30 14 14 19 0 0 0 0 0 0 0 0 0 0 0 0 0 0 0 0 0 0 0 0 0 0 0 0 0 
0 0 0 0 0 0 0 0 0 0 0 0 0 0 0 0 0 0 25 17 21 14 14 30 30 30 30 30 12 2 2 2 11 5 32 32 4 30 14 30 30 14 14 14 5 32 4 30 14 14 14 14 30 30 30 14 5 32 6 2 2 2 2 2 2 2 2 9 32 4 30 30 14 14 20 17 24 0 0 0 0 0 0 0 0 0 0 0 0 0 0 0 0 0 0 0 0 0 0 0 
0 0 0 0 0 0 0 0 0 0 0 0 0 0 0 25 17 17 21 14 14 30 30 30 14 14 14 30 30 14 30 30 30 5 32 6 14 14 14 14 30 30 30 14 5 32 4 30 30 30 30 14 14 30 30 30 5 32 4 30 14 14 14 30 30 30 14 5 32 4 30 14 14 30 14 14 20 17 24 0 0 0 0 0 0 0 0 0 0 0 0 0 0 0 0 0 0 0 0 0 
0 0 0 0 0 0 0 0 0 0 0 0 0 0 0 18 10 3 3 3 3 3 3 13 30 14 30 14 30 14 14 10 3 7 32 8 3 3 3 3 3 3 13 10 7 32 8 13 14 14 14 30 14 14 14 30 5 32 4 30 30 30 14 14 14 30 30 5 32 4 30 14 30 30 14 30 14 14 20 17 17 24 0 0 0 0 0 0 0 0 0 0 0 0 0 0 0 0 0 0 
0 0 0 0 0 0 0 0 0 0 0 0 0 0 0 18 5 31 31 31 31 31 31 4 30 30 30 14 30 14 30 5 32 32 32 32 32 32 32 32 32 32 8 7 32 32 32 8 3 3 3 3 3 3 3 3 7 32 4 30 30 14 14 14 14 30 30 5 32 4 30 30 30 14 30 30 14 14 14 14 14 20 24 0 0 0 0 0 0 0 0 0 0 0 0 0 0 0 0 0 
0 0 0 0 0 0 0 0 0 0 0 0 0 0 0 18 5 31 29 29 29 29 31 4 14 14 30 30 30 30 14 5 32 6 2 2 2 2 2 2 9 32 32 32 32 32 32 32 32 32 32 32 32 32 32 32 32 32 4 30 14 14 30 14 14 14 30 5 32 4 30 30 14 30 14 3 3 3 3 3 3 13 20 24 0 0 0 0 0 0 0 0 0 0 0 0 0 0 0 0 
0 0 0 0 0 0 0 0 0 0 0 0 0 0 0 18 5 31 29 29 29 29 31 4 30 14 30 30 14 30 14 5 32 4 30 30 30 30 30 14 12 2 2 9 32 32 32 6 2 2 2 2 2 2 2 2 2 2 11 30 14 30 14 14 30 30 30 5 32 4 30 30 14 14 5 31 31 31 31 31 31 8 13 19 0 0 0 0 0 0 0 0 0 0 0 0 0 0 0 0 
0 0 0 0 0 0 0 0 0 0 0 0 0 0 0 18 5 31 29 29 29 29 31 8 13 14 30 30 30 30 14 5 32 4 30 14 30 30 30 14 30 30 14 12 9 32 6 11 14 14 30 30 30 30 14 14 14 14 30 30 30 30 30 14 14 30 30 5 32 8 3 3 3 3 7 31 32 32 32 32 31 31 4 20 24 0 0 0 0 0 0 0 0 0 0 0 0 0 0 0 
0 0 0 0 0 0 0 0 0 0 0 0 0 0 25 21 5 31 29 29 29 29 31 32 8 3 3 3 3 3 3 7 32 4 30 30 30 30 14 14 14 14 14 14 5 32 4 30 30 10 3 3 3 3 3 3 3 3 3 3 3 3 3 3 13 30 30 5 32 32 32 32 32 32 32 32 32 32 32 32 32 31 4 14 19 0 0 0 0 0 0 0 0 0 0 0 0 0 0 0 
0 0 0 0 0 0 0 0 0 0 0 0 0 0 18 14 5 31 29 29 29 29 29 32 32 32 32 32 32 32 32 32 32 4 30 30 30 14 14 30 30 30 30 14 5 32 4 30 30 5 32 32 32 32 32 32 32 32 32 32 32 32 32 32 8 13 30 12 2 2 2 2 2 2 9 31 32 32 32 32 32 31 4 30 19 0 0 0 0 0 0 0 0 0 0 0 0 0 0 0 
0 0 0 0 0 0 0 0 0 0 0 0 0 0 18 30 5 31 29 29 29 29 31 32 6 2 2 2 2 2 2 2 2 11 30 14 30 14 14 14 14 14 30 14 5 32 4 30 14 5 32 6 2 2 2 2 2 2 9 32 6 2 9 32 32 8 13 30 30 30 14 14 14 14 5 31 31 31 31 31 31 31 4 14 19 0 0 0 0 0 0 0 0 0 0 0 0 0 0 0 
0 0 0 0 0 0 0 0 0 0 0 0 0 0 18 14 5 31 29 29 29 29 31 6 11 30 14 30 30 14 14 30 14 14 30 14 30 30 14 14 14 14 30 30 5 32 8 3 3 7 32 4 14 14 30 30 30 30 5 32 4 30 12 9 32 32 8 13 14 30 14 30 14 14 12 2 2 2 2 2 2 2 11 22 26 0 0 0 0 0 0 0 0 0 0 0 0 0 0 0 
0 0 0 0 0 0 0 0 0 0 0 0 0 0 18 30 5 31 29 29 29 29 31 4 30 30 30 30 30 30 30 30 30 30 30 14 14 30 30 14 30 14 14 30 5 32 32 32 32 32 32 4 30 30 30 14 14 14 5 32 4 14 14 12 9 32 32 8 13 30 30 30 14 30 14 30 14 14 30 30 30 14 22 26 0 0 0 0 0 0 0 0 0 0 0 0 0 0 0 0 
0 0 0 0 0 0 0 0 0 0 0 0 0 0 18 14 5 31 31 31 31 31 31 4 14 30 14 14 30 30 14 14 14 14 14 14 14 14 30 30 30 30 14 14 5 32 6 2 2 2 2 11 30 30 30 14 22 23 14 1 14 22 23 14 12 9 32 32 4 30 14 30 14 30 30 14 22 16 16 16 16 16 26 0 0 0 0 0 0 0 0 0 0 0 0 0 0 0 0 0 
0 0 0 0 0 0 0 0 0 0 0 0 0 0 27 23 12 2 2 2 2 2 2 11 14 30 30 30 30 14 14 14 30 30 14 14 14 14 30 30 14 30 14 14 5 32 4 14 30 30 30 30 30 14 14 22 26 27 23 14 22 26 27 23 14 12 9 32 4 14 14 14 14 30 30 14 19 0 0 0 0 0 0 0 0 0 0 0 0 0 0 0 0 0 0 0 0 0 0 0 
0 0 0 0 0 0 0 0 0 0 0 0 0 0 0 18 14 14 14 30 30 14 14 30 30 30 30 14 14 14 30 30 14 30 30 30 30 14 14 30 30 14 14 30 5 32 4 14 30 30 30 30 30 14 22 26 0 0 18 14 19 0 0 27 23 14 5 32 4 14 14 14 30 30 30 22 26 0 0 0 0 0 0 0 0 0 0 0 0 0 0 0 0 0 0 0 0 0 0 0 
0 0 0 0 0 0 0 0 0 0 0 0 0 0 0 27 23 14 14 14 30 14 30 14 30 14 14 14 30 14 30 14 14 14 14 14 30 14 30 14 30 14 14 30 5 32 4 30 14 14 14 30 14 14 20 24 0 0 27 16 26 0 0 25 21 14 5 32 4 14 14 14 30 30 30 19 0 0 0 0 0 0 0 0 0 0 0 0 0 0 0 0 0 0 0 0 0 0 0 0 
0 0 0 0 0 0 0 0 0 0 0 0 0 0 0 0 27 23 14 14 30 30 30 14 14 14 14 14 30 14 30 14 14 30 30 30 14 14 30 30 30 14 14 30 5 32 8 13 30 30 14 30 14 30 14 19 0 0 0 0 0 0 0 18 14 30 5 32 4 10 3 3 3 13 30 20 24 0 0 0 0 0 0 0 0 0 0 0 0 0 0 0 0 0 0 0 0 0 0 0 
0 0 0 0 0 0 0 0 0 0 0 0 0 0 0 0 0 27 23 14 14 30 30 14 14 30 30 30 14 14 30 30 30 30 14 14 30 14 30 30 30 14 30 30 5 32 32 4 30 14 14 30 30 30 14 20 24 0 0 0 0 0 25 21 14 30 5 32 8 7 32 32 32 4 14 14 19 0 0 0 0 0 0 0 0 0 0 0 0 0 0 0 0 0 0 0 0 0 0 0 
0 0 0 0 0 0 0 0 0 0 0 0 0 0 0 0 0 0 27 23 14 14 14 14 30 30 14 14 14 30 14 14 14 14 30 30 30 30 14 14 30 14 30 14 12 9 32 4 30 14 14 30 30 14 14 14 20 0 0 0 0 0 21 14 14 30 5 32 32 32 32 32 32 4 30 14 19 0 0 0 0 0 0 0 0 0 0 0 0 0 0 0 0 0 0 0 0 0 0 0 
0 0 0 0 0 0 0 0 0 0 0 0 0 0 0 0 0 0 0 27 16 23 14 14 14 30 30 30 30 30 14 14 1 14 14 14 14 14 14 14 14 14 30 14 14 5 32 4 30 30 30 30 30 14 14 14 14 20 24 0 25 21 14 14 30 30 5 32 6 9 32 32 32 4 30 14 20 24 0 0 0 0 0 0 0 0 0 0 0 0 0 0 0 0 0 0 0 0 0 0 
0 0 0 0 0 0 0 0 0 0 0 0 0 0 0 0 0 0 0 0 0 18 14 14 30 30 14 14 30 14 14 1 1 1 1 14 14 14 30 14 14 14 30 30 14 5 32 4 30 14 14 14 30 30 30 30 14 14 20 17 21 14 14 14 14 30 5 32 4 12 2 2 2 11 14 14 14 19 0 0 0 0 0 0 0 0 0 0 0 0 0 0 0 0 0 0 0 0 0 0 
0 0 0 0 0 0 0 0 0 0 0 0 0 0 0 0 0 0 0 0 0 27 23 14 30 30 30 30 30 14 14 1 1 1 1 1 14 30 30 14 30 14 14 30 14 5 32 4 30 30 30 14 30 30 30 30 30 14 14 14 14 14 30 30 14 30 5 32 4 14 30 30 14 30 30 14 14 19 0 0 0 0 0 0 0 0 0 0 0 0 0 0 0 0 0 0 0 0 0 0 
0 0 0 0 0 0 0 0 0 0 0 0 0 0 0 0 0 0 0 0 0 0 18 14 14 14 14 30 30 14 14 1 14 14 14 1 14 14 30 30 30 30 30 30 14 5 32 4 30 30 14 30 30 14 14 30 30 30 30 14 14 30 30 30 14 30 5 32 4 14 30 30 30 30 30 30 14 20 24 0 0 0 0 0 0 0 0 0 0 0 0 0 0 0 0 0 0 0 0 0 
0 0 0 0 0 0 0 0 0 0 0 0 0 0 0 0 0 0 0 0 0 25 21 14 14 14 30 30 30 14 1 1 5 32 4 14 14 14 30 14 14 30 30 30 14 5 32 4 14 30 30 14 14 14 14 14 14 14 14 10 3 3 3 3 3 3 7 32 4 30 14 14 14 14 14 14 30 14 19 0 0 0 0 0 0 0 0 0 0 0 0 0 0 0 0 0 0 0 0 0 
0 0 0 0 0 0 0 0 0 0 0 0 0 0 0 0 0 0 0 25 17 21 14 14 14 14 14 14 14 14 1 1 5 32 4 30 30 30 14 14 30 30 14 14 1 5 32 4 14 14 14 14 14 14 30 30 1 1 1 5 32 32 32 32 32 32 32 32 4 14 30 14 1 14 30 14 30 14 19 0 0 0 0 0 0 0 0 0 0 0 0 0 0 0 0 0 0 0 0 0 
0 0 0 0 0 0 0 0 0 0 0 0 0 0 0 0 0 0 0 18 14 14 14 14 14 30 30 14 14 14 14 14 5 32 4 30 14 30 30 30 30 14 14 1 1 5 32 4 14 30 30 30 30 14 14 14 1 1 1 5 32 6 2 9 32 6 2 2 11 30 30 14 1 14 14 14 30 14 19 0 0 0 0 0 0 0 0 0 0 0 0 0 0 0 0 0 0 0 0 0 
0 0 0 0 0 0 0 0 0 0 0 0 0 0 0 0 0 0 0 18 14 14 30 30 30 30 30 10 3 3 3 3 7 32 8 3 3 3 3 3 3 3 3 3 3 7 32 8 3 3 3 3 3 3 3 3 3 3 3 7 32 4 14 5 32 4 14 14 14 30 14 1 1 14 30 30 30 14 19 0 0 0 0 0 0 0 0 0 0 0 0 0 0 0 0 0 0 0 0 0 
0 0 0 0 0 0 0 0 0 0 0 0 0 0 0 0 0 0 0 18 14 30 30 14 30 14 30 5 32 32 32 32 32 32 32 32 32 32 32 32 32 32 32 32 32 32 32 32 32 32 32 32 32 32 32 32 32 32 32 32 32 4 14 5 32 4 30 14 30 14 14 1 1 14 30 14 30 14 19 0 0 0 0 0 0 0 0 0 0 0 0 0 0 0 0 0 0 0 0 0 
0 0 0 0 0 0 0 0 0 0 0 0 0 0 0 0 0 0 0 18 14 30 30 30 30 14 30 5 32 6 2 2 2 2 2 2 2 2 2 2 2 2 2 2 2 2 2 2 2 2 2 2 2 2 2 2 2 2 2 2 2 11 14 5 32 4 30 14 30 30 14 14 14 14 14 30 30 14 19 0 0 0 0 0 0 0 0 0 0 0 0 0 0 0 0 0 0 0 0 0 
0 0 0 0 0 0 0 0 0 0 0 0 0 0 0 0 0 0 0 18 14 30 30 14 30 30 14 5 32 4 14 30 14 14 30 30 14 14 30 30 14 30 30 30 30 30 30 14 14 3 3 3 13 14 14 30 30 30 30 14 14 30 30 5 32 4 14 30 30 30 30 5 32 4 14 30 14 14 19 0 0 0 0 0 0 0 0 0 0 0 0 0 0 0 0 0 0 0 0 0 
0 0 0 0 0 0 0 0 0 0 0 0 0 0 0 0 0 0 0 18 14 30 14 14 30 14 14 5 32 4 30 30 14 14 30 30 14 14 30 30 14 14 30 14 14 30 30 10 7 31 31 31 8 13 14 30 14 14 14 30 30 30 30 5 32 8 3 3 3 3 3 7 32 4 14 30 14 14 19 0 0 0 0 0 0 0 0 0 0 0 0 0 0 0 0 0 0 0 0 0 
0 0 0 0 0 0 0 0 0 0 0 0 0 0 0 0 0 0 0 18 14 30 30 30 14 14 14 5 32 4 30 14 30 14 14 30 14 14 30 14 14 14 30 30 30 30 14 5 31 31 32 31 31 4 14 14 30 30 30 30 14 14 30 5 32 32 32 32 32 32 32 32 32 4 14 30 14 22 26 0 0 0 0 0 0 0 0 0 0 0 0 0 0 0 0 0 0 0 0 0 
0 0 0 0 0 0 0 0 0 0 0 0 0 0 0 0 0 0 0 18 14 30 14 14 30 30 14 5 32 4 30 30 30 30 14 30 30 14 30 30 30 30 30 30 30 30 30 5 31 32 32 32 31 4 14 30 30 14 14 30 30 14 14 5 32 6 2 2 2 2 2 2 2 11 30 30 14 19 0 0 0 0 0 0 0 0 0 0 0 0 0 0 0 0 0 0 0 0 0 0 
0 0 0 0 0 0 0 0 0 0 0 0 0 0 0 0 0 0 0 18 14 30 14 30 30 30 30 5 32 4 14 14 14 14 30 30 30 30 30 14 14 30 14 30 30 14 30 5 31 32 32 32 31 4 14 30 14 1 1 14 30 14 14 5 32 4 14 30 30 14 30 30 14 14 30 14 14 19 0 0 0 0 0 0 0 0 0 0 0 0 0 0 0 0 0 0 0 0 0 0 
0 0 0 0 0 0 0 0 0 0 0 0 0 0 0 0 0 0 0 18 14 30 30 30 14 30 30 5 32 8 3 3 3 3 3 3 3 3 13 14 30 30 14 30 30 14 30 5 31 31 32 31 31 4 30 30 14 1 1 1 3 3 3 7 32 4 14 30 30 30 30 30 30 30 14 14 14 19 0 0 0 0 0 0 0 0 0 0 0 0 0 0 0 0 0 0 0 0 0 0 
0 0 0 0 0 0 0 0 0 0 0 0 0 0 0 0 0 0 0 18 14 14 14 14 14 30 14 5 32 32 32 32 32 32 32 32 32 32 4 14 30 30 30 30 30 30 30 12 2 9 32 6 2 11 30 14 14 1 1 1 32 32 32 32 32 4 14 30 14 14 14 14 30 14 14 14 22 26 0 0 0 0 0 0 0 0 0 0 0 0 0 0 0 0 0 0 0 0 0 0 
0 0 0 0 0 0 0 0 0 0 0 0 0 0 0 0 0 0 0 18 14 30 30 14 14 14 14 12 2 2 2 2 2 2 2 2 9 32 4 14 14 14 14 14 30 30 30 14 30 5 32 4 14 14 30 30 30 30 14 14 2 2 2 2 2 11 14 14 14 14 14 14 14 14 22 16 26 0 0 0 0 0 0 0 0 0 0 0 0 0 0 0 0 0 0 0 0 0 0 0 
0 0 0 0 0 0 0 0 0 0 0 0 0 0 0 0 0 0 0 18 14 30 30 14 30 30 30 30 30 30 14 14 14 10 3 3 7 32 8 3 3 3 13 14 30 14 30 30 30 5 32 4 14 14 14 14 30 30 30 14 14 30 30 30 14 14 14 22 16 16 16 16 16 16 26 0 0 0 0 0 0 0 0 0 0 0 0 0 0 0 0 0 0 0 0 0 0 0 0 0 
0 0 0 0 0 0 0 0 0 0 0 0 0 0 0 0 0 0 0 18 14 30 30 30 30 14 30 30 14 30 14 29 29 29 31 31 31 32 31 31 31 31 4 14 30 30 30 14 14 5 32 4 30 30 14 14 14 14 30 30 30 30 14 14 14 14 22 26 0 0 0 0 0 0 0 0 0 0 0 0 0 0 0 0 0 0 0 0 0 0 0 0 0 0 0 0 0 0 0 0 
0 0 0 0 0 0 0 0 0 0 0 0 0 0 0 0 0 0 0 18 14 14 14 14 30 30 30 14 14 30 14 29 29 29 31 32 32 32 32 32 32 31 8 3 3 3 3 3 3 7 32 4 30 30 30 30 14 14 14 14 14 14 14 14 14 14 19 0 0 0 0 0 0 0 0 0 0 0 0 0 0 0 0 0 0 0 0 0 0 0 0 0 0 0 0 0 0 0 0 0 
0 0 0 0 0 0 0 0 0 0 0 0 0 0 0 0 0 0 0 18 14 14 14 14 14 14 14 14 14 14 14 29 29 29 31 32 32 32 32 32 32 32 32 32 32 32 32 32 32 32 32 4 14 14 14 30 30 30 30 30 14 30 30 14 14 22 26 0 0 0 0 0 0 0 0 0 0 0 0 0 0 0 0 0 0 0 0 0 0 0 0 0 0 0 0 0 0 0 0 0 
0 0 0 0 0 0 0 0 0 0 0 0 0 0 0 0 0 0 0 18 14 30 30 14 30 30 30 30 14 30 14 29 29 29 31 31 31 31 32 32 32 31 6 2 2 2 2 2 2 2 2 11 14 14 30 30 30 14 14 30 30 30 14 14 14 19 0 0 0 0 0 0 0 0 0 0 0 0 0 0 0 0 0 0 0 0 0 0 0 0 0 0 0 0 0 0 0 0 0 0 
0 0 0 0 0 0 0 0 0 0 0 0 0 0 0 0 0 0 0 18 14 30 30 30 30 14 14 30 30 14 14 29 29 29 29 29 29 31 32 32 32 31 4 14 14 30 30 30 30 30 30 30 14 14 14 14 14 14 14 14 14 14 14 14 22 26 0 0 0 0 0 0 0 0 0 0 0 0 0 0 0 0 0 0 0 0 0 0 0 0 0 0 0 0 0 0 0 0 0 0 
0 0 0 0 0 0 0 0 0 0 0 0 0 0 0 0 0 0 0 18 14 30 30 14 14 14 30 14 14 30 14 29 29 29 29 29 29 32 32 32 32 31 4 14 14 14 14 14 14 14 14 30 30 30 30 30 30 30 14 14 14 14 22 16 26 0 0 0 0 0 0 0 0 0 0 0 0 0 0 0 0 0 0 0 0 0 0 0 0 0 0 0 0 0 0 0 0 0 0 0 
0 0 0 0 0 0 0 0 0 0 0 0 0 0 0 0 0 0 0 18 14 14 14 30 30 30 30 14 14 30 14 29 29 29 29 29 29 31 32 32 32 31 4 22 16 16 16 23 14 14 14 14 14 14 14 14 14 14 14 22 16 16 26 0 0 0 0 0 0 0 0 0 0 0 0 0 0 0 0 0 0 0 0 0 0 0 0 0 0 0 0 0 0 0 0 0 0 0 0 0 
0 0 0 0 0 0 0 0 0 0 0 0 0 0 0 0 0 0 0 27 23 14 14 14 14 14 14 30 30 14 14 29 29 29 29 29 29 31 31 31 31 31 4 19 0 0 0 27 16 16 16 16 16 16 16 16 16 16 16 26 0 0 0 0 0 0 0 0 0 0 0 0 0 0 0 0 0 0 0 0 0 0 0 0 0 0 0 0 0 0 0 0 0 0 0 0 0 0 0 0 
0 0 0 0 0 0 0 0 0 0 0 0 0 0 0 0 0 0 0 0 0 23 14 14 14 14 14 14 14 14 14 29 29 29 29 29 29 29 29 2 2 2 11 19 0 0 0 0 0 0 0 0 0 0 0 0 0 0 0 0 0 0 0 0 0 0 0 0 0 0 0 0 0 0 0 0 0 0 0 0 0 0 0 0 0 0 0 0 0 0 0 0 0 0 0 0 0 0 0 0 
0 0 0 0 0 0 0 0 0 0 0 0 0 0 0 0 0 0 0 0 0 27 16 16 16 16 16 16 23 14 14 14 14 14 14 14 14 14 14 14 14 14 14 19 0 0 0 0 0 0 0 0 0 0 0 0 0 0 0 0 0 0 0 0 0 0 0 0 0 0 0 0 0 0 0 0 0 0 0 0 0 0 0 0 0 0 0 0 0 0 0 0 0 0 0 0 0 0 0 0 
0 0 0 0 0 0 0 0 0 0 0 0 0 0 0 0 0 0 0 0 0 0 0 0 0 0 0 0 27 16 16 16 16 16 16 16 16 16 16 16 16 16 16 26 0 0 0 0 0 0 0 0 0 0 0 0 0 0 0 0 0 0 0 0 0 0 0 0 0 0 0 0 0 0 0 0 0 0 0 0 0 0 0 0 0 0 0 0 0 0 0 0 0 0 0 0 0 0 0 0 
0 0 0 0 0 0 0 0 0 0 0 0 0 0 0 0 0 0 0 0 0 0 0 0 0 0 0 0 0 0 0 0 0 0 0 0 0 0 0 0 0 0 0 0 0 0 0 0 0 0 0 0 0 0 0 0 0 0 0 0 0 0 0 0 0 0 0 0 0 0 0 0 0 0 0 0 0 0 0 0 0 0 0 0 0 0 0 0 0 0 0 0 0 0 0 0 0 0 0 0 
0 0 0 0 0 0 0 0 0 0 0 0 0 0 0 0 0 0 0 0 0 0 0 0 0 0 0 0 0 0 0 0 0 0 0 0 0 0 0 0 0 0 0 0 0 0 0 0 0 0 0 0 0 0 0 0 0 0 0 0 0 0 0 0 0 0 0 0 0 0 0 0 0 0 0 0 0 0 0 0 0 0 0 0 0 0 0 0 0 0 0 0 0 0 0 0 0 0 0 0 
0 0 0 0 0 0 0 0 0 0 0 0 0 0 0 0 0 0 0 0 0 0 0 0 0 0 0 0 0 0 0 0 0 0 0 0 0 0 0 0 0 0 0 0 0 0 0 0 0 0 0 0 0 0 0 0 0 0 0 0 0 0 0 0 0 0 0 0 0 0 0 0 0 0 0 0 0 0 0 0 0 0 0 0 0 0 0 0 0 0 0 0 0 0 0 0 0 0 0 0 
0 0 0 0 0 0 0 0 0 0 0 0 0 0 0 0 0 0 0 0 0 0 0 0 0 0 0 0 0 0 0 0 0 0 0 0 0 0 0 0 0 0 0 0 0 0 0 0 0 0 0 0 0 0 0 0 0 0 0 0 0 0 0 0 0 0 0 0 0 0 0 0 0 0 0 0 0 0 0 0 0 0 0 0 0 0 0 0 0 0 0 0 0 0 0 0 0 0 0 0 
0 0 0 0 0 0 0 0 0 0 0 0 0 0 0 0 0 0 0 0 0 0 0 0 0 0 0 0 0 0 0 0 0 0 0 0 0 0 0 0 0 0 0 0 0 0 0 0 0 0 0 0 0 0 0 0 0 0 0 0 0 0 0 0 0 0 0 0 0 0 0 0 0 0 0 0 0 0 0 0 0 0 0 0 0 0 0 0 0 0 0 0 0 0 0 0 0 0 0 0 
0 0 0 0 0 0 0 0 0 0 0 0 0 0 0 0 0 0 0 0 0 0 0 0 0 0 0 0 0 0 0 0 0 0 0 0 0 0 0 0 0 0 0 0 0 0 0 0 0 0 0 0 0 0 0 0 0 0 0 0 0 0 0 0 0 0 0 0 0 0 0 0 0 0 0 0 0 0 0 0 0 0 0 0 0 0 0 0 0 0 0 0 0 0 0 0 0 0 0 0 
0 0 0 0 0 0 0 0 0 0 0 0 0 0 0 0 0 0 0 0 0 0 0 0 0 0 0 0 0 0 0 0 0 0 0 0 0 0 0 0 0 0 0 0 0 0 0 0 0 0 0 0 0 0 0 0 0 0 0 0 0 0 0 0 0 0 0 0 0 0 0 0 0 0 0 0 0 0 0 0 0 0 0 0 0 0 0 0 0 0 0 0 0 0 0 0 0 0 0 0 
0 0 0 0 0 0 0 0 0 0 0 0 0 0 0 0 0 0 0 0 0 0 0 0 0 0 0 0 0 0 0 0 0 0 0 0 0 0 0 0 0 0 0 0 0 0 0 0 0 0 0 0 0 0 0 0 0 0 0 0 0 0 0 0 0 0 0 0 0 0 0 0 0 0 0 0 0 0 0 0 0 0 0 0 0 0 0 0 0 0 0 0 0 0 0 0 0 0 0 0 
